11111111111111
100000000010E1
10C00000001001
10001111100011
10001000100001
10010000100001
10010000000001
10010000100001
10010100100001
1P000100000001
10000000000001
11111111111111