11111111111111
100100000010E1
100C0000001001
10011111100011
10001000100001
10010000100001
10010000000001
10010000100001
10010100100001
1P000100000001
10000000000001
11111111111111