11111111111111
100000000010E1
100C00000010C1
10001111100011
1000100C100001
10010000100001
10010000000001
100100001000C1
10010100100001
1P0001C0000001
10000000000001
11111111111111